60
Dog: Con cho
Cat: Con meo
Chick: Con ga con
Turkey: Ga Tay
Camel: Con lac da
Bull: Con bo duc
Cow: Con bo cai
Calf: Con be
Fox: Con cao
Lion: Con su tu
Bear: Con gau
Elephant: Con voi
Squirrel: Con soc
Porcupine: Con nhim
Hippopotamus: Con ha ma
Raccoon: Con gau meo
Giraffe: Con huou cao co
Rhinoceros: Con te giac
Jaguar: Con bao dom
Chimpanzee: Con hac tinh tinh
Donkey: Con lua
Zebra: Con ngua van
Panda: Con gau truc
Squirrel: Con soc
Kangaroo: Con chuot tui
Hedgehog: Con nhim
Wolf: Con cho soi
Alligator: Con ca sau
Bat: Con doi
Boar: Con lon hoang
Beaver: Con hai ly
Buffalo: Con trau nuoc
Porcupine: Con nhim
Ladybug: Con bo rua
Grasshopper: Con chau chau
Cockroach: Con gian
Honeycomb: Sap ong
Parasites: Ky sinh trung
Caterpillar: Sau buom
Mosquito: Con muoi
Tarantula: Con nhen lon
Frog: Con ech
Crocodile: Con ca sau
Lizard: Con than lan
Chameleon: Con tac ke hoa
Dinosaurs: Con khung long
Toad: Con coc
Cobra: Con ran ho mang
Turtle: Con rua
Seal: Con hai cau
Penguin: Con chim canh cut
Squid: Con muc
Stingray: Ca duoi
Jellyfish: Con sua
Swordfish: Con ca kiem
Starfish: Con sao bien
Crab: Con cua
Seahorse: Con ca ngua
Octopus: Bach tuoc
Turtle: Con rua