48
Sneaker: Giay the thao
Sandals: Dep xang dan
Boots: Bot
Loafer: Giay luoi
Clog: Guoc
Stilettos: Giay got nhon
Slippers: Dep di trong nha
Hat: Mu
Beret: Mu noi
Fedora: Mu phot mem
Snapback: Mu luoi trai phang
Jeans: Quan bo
Miniskirt: Vay ngan
Dress: Vay lien
Trousers: Quan dai
Shorts: Quan sooc
Blouse: Ao so mi nu
Shirt: Ao so mi
Bikini: Bikini
shirt: Ao phong
Pullover: Ao len chui dau
Jumper: Ao len
Suit: Bo com le
Jacket: Ao khoac ngan
Anorak: Ao khoac co mu
Overcoat: Ao mang to
Miniskirt: Vay ngan
Pyjamas: Do ngu
Raincoat: Ao mua
Nightie: Vay ngu
Tights: Quan tat
Tracksuitu: Do the thao
Bracelet: Vong tay
Earrings: Khuyen tai
Glasses: Kinh
Handbag: Tui
Piercing: Khuyen
Necklace: Vong co
Purse: Vi nu
Sunglasses: Kinh ram
Ring: Nhan
Watch: Dong ho
Size: Kich co
Tight: Chat
Loose: Long
Zip: Khoa keo
Button: Khuy
Pocket: Tui quan a