34
Grandparents: Ong ba
Grandfather: Ong ngoai/ Ong noi
Grandmother: Ba ngoai/ ba noi
Aunt: Co/ di
Uncle: Cau/ chu
Cousin: Anh chi em ho
Father-in-law: Bo chong/ vo
Mother-in-law: Me chong/ vo
Sister-in-law: Chi dau / em dau
Brother-in-law: Anh re, em re
Parents: Ba me 
Stepparent: Cha me ke
Mother: Me
Father: Bo
Sibling: Anh chi em ruot
Spouse: Vo chong
Husband: Chong
Wife: Vo
Child: Con cai
Daughter: Con gai
Son: Con trai
Stepfather: Cha duong
Stepmother: Me ke
Ex-husband: Chong cu
Ex-wife: Vo cu
Half-brother: Anh/em trai cung cha/me khac me/cha
Step brother: Con trai rieng cua bo/me ke
Half-sister: Chi/em gai cung cha/me khac me/cha
Step sister: Con gai rieng cua bo me ke
Grandchildren: Cac chau (cua ong ba)
Granddaughter: Chau gai (cua ong ba)
Grandson: Chau trai (cua ong ba)
Nephew: Chau trai ( cua co/ di/ chu …)
Niece: Chau gai ( cua co/ di/ chu …)